ABL1	Oncogene
ABL2	Oncogene
AKT1	Oncogene
AKT2	Oncogene
ATF1	Oncogene
BCL11A	Oncogene
BCL2	Oncogene
BCL3	Oncogene
BCL6	Oncogene
BCR	Oncogene
BRAF	Oncogene
CARD11	Oncogene
CBLB	Oncogene
CBLC	Oncogene
CCND1	Oncogene
CCND2	Oncogene
CCND3	Oncogene
CDX2	Oncogene
CTNNB1	Oncogene
DDB2	Oncogene
DDIT3	Oncogene
DDX6	Oncogene
DEK	Oncogene
EGFR	Oncogene
ELK4	Oncogene
ERBB2	Oncogene
ETV4	Oncogene
ETV6	Oncogene
EVI1	Oncogene
EWSR1	Oncogene
FEV	Oncogene
FGFR1	Oncogene
FGFR1OP	Oncogene
FGFR2	Oncogene
FUS	Oncogene
GOLGA5	Oncogene
GOPC	Oncogene
HMGA1	Oncogene
HMGA2	Oncogene
HRAS	Oncogene
IRF4	Oncogene
JUN	Oncogene
KIT	Oncogene
KRAS	Oncogene
LCK	Oncogene
LMO2	Oncogene
MAF	Oncogene
MAFB	Oncogene
MAML2	Oncogene
MDM2	Oncogene
MET	Oncogene
MITF	Oncogene
MLL	Oncogene
MPL	Oncogene
MYB	Oncogene
MYC	Oncogene
MYCL1	Oncogene
MYCN	Oncogene
NCOA4	Oncogene
NFKB2	Oncogene
NRAS	Oncogene
NTRK1	Oncogene
NUP214	Oncogene
PAX8	Oncogene
PDGFB	Oncogene
PIK3CA	Oncogene
PIM1	Oncogene
PLAG1	Oncogene
PPARG	Oncogene
PTPN11	Oncogene
RAF1	Oncogene
REL	Oncogene
RET	Oncogene
ROS1	Oncogene
SMO	Oncogene
SS18	Oncogene
TCL1A	Oncogene
TET2	Oncogene
TFG	Oncogene
TLX1	Oncogene
TPR	Oncogene
USP6	Oncogene
APC	Suppressor
ARHGEF12	Suppressor
ATM	Suppressor
BCL11B	Suppressor
BLM	Suppressor
BMPR1A	Suppressor
BRCA1	Suppressor
BRCA2	Suppressor
CARS	Suppressor
CBFA2T3	Suppressor
CDH1	Suppressor
CDH11	Suppressor
CDK6	Suppressor
CDKN2C	Suppressor
CEBPA	Suppressor
CHEK2	Suppressor
CREB1	Suppressor
CREBBP	Suppressor
CYLD	Suppressor
DDX5	Suppressor
EXT1	Suppressor
EXT2	Suppressor
FBXW7	Suppressor
FH	Suppressor
FLT3	Suppressor
FOXP1	Suppressor
GPC3	Suppressor
IDH1	Suppressor
IL2	Suppressor
JAK2	Suppressor
MAP2K4	Suppressor
MDM4	Suppressor
MEN1	Suppressor
MLH1	Suppressor
MSH2	Suppressor
NF1	Suppressor
NF2	Suppressor
NOTCH1	Suppressor
NPM1	Suppressor
NR4A3	Suppressor
NUP98	Suppressor
PALB2	Suppressor
PML	Suppressor
PTEN	Suppressor
RB1	Suppressor
RUNX1	Suppressor
SDHB	Suppressor
SDHD	Suppressor
SMARCA4	Suppressor
SMARCB1	Suppressor
SOCS1	Suppressor
STK11	Suppressor
SUFU	Suppressor
SUZ12	Suppressor
SYK	Suppressor
TCF3	Suppressor
TNFAIP3	Suppressor
TP53	Suppressor
TSC1	Suppressor
TSC2	Suppressor
VHL	Suppressor
WRN	Suppressor
WT1	Suppressor
